#,#,#,#,#,#,#,#,#,#,#,#,#,#,#,#,#,#,#,#,#,#,#,#,#,#,#,#,#,#,#,#,#,#,#,#,#,#,#,#
#, , , , , , , , , , , , , , , , , , , , , , , , , , , , , , , , , , , , , , ,#
#, , , , , , , , , , , , , , , , , , , , , , , , , , , , , , , , , , , , , , ,#
#, , , , , , , , , , , , , , , , , , , , , , , , , , , , , , , , , , , , , , ,#
#, , , , , , , , , , , , , , , , , , , , , , , , , , , , , , , , , , , , , , ,#
#, , , , , , , , , , , , , , , , , , , , , , , , , , , , , , , , , , , , , , ,#
#, , , , , , , , , , , , , , , , , , , , , , , , , , , , , , , , , , , , , , ,#
#, , , , , , , , , , , , , , , , , , , , , , , , , , , , , , , , , , , , , , ,#
#, , , , , , , , , , , , , , , , , , , , , , , , , , , , , , , , , , , , , , ,#
#, , , , , , , , , , , , , , , , , , , , , , , , , , , , , , , , , , , , , , ,#
#, , , , , , , , , , , , , , , , , , , , , , , , , , , , , , , , , , , , , , ,#
#, , , , , , , , , , , , , , , , , , , , , , , , , , , , , , , , , , , , , , ,#
#, , , , , , , , , , , , , , , , , , , , , , , , , , , , , , , , , , , , , , ,#
#, , , , , , , , , , , , , , , , , , , , , , , , , , , , , , , , , , , , , , ,#
#, , , , , , , , , , , , , , , , , , , , , , , , , , , , , , , , , , , , , , ,#
#, , , , , , , , , , , , , , , , , , , , , , , , , , , , , , , , , , , , , , ,#
#, , , , , , , , , , , , , , , , , , , , , , , , , , , , , , , , , , , , , , ,#
#, , , , , , , , , , , , , , , , , , , , , , , , , , , , , , , , , , , , , , ,#
#, , , , , , , , , , , , , , , , , , , , , , , , , , , , , , , , , , , , , , ,#
#, , , , , , , , , , , , , , , , , , , , , , , , , , , , , , , , , , , , , , ,#
#, , , , , , , , , , , , , , , , , , , , , , , , , , , , , , , , , , , , , , ,#
#, , , , , , , , , , , , , , , , , , , , , , , , , , , , , , , , , , , , , , ,#
#, , , , , , , , , , , , , , , , , , , , , , , , , , , , , , , , , , , , , , ,#
#, , , , , , , , , , , , , , , , , , , , , , , , , , , , , , , , , , , , , , ,#
#, , , , , , , , , , , , , , , , , , , , , , , , , , , , , , , , , , , , , , ,#
#, , , , , , , , , , , , , , , , , , , , , , , , , , , , , , , , , , , , , , ,#
#, , , , , , , , , , , , , , , , , , , , , , , , , , , , , , , , , , , , , , ,#
#, , , , , , , , , , , , , , , , , , , , , , , , , , , , , , , , , , , , , , ,#
#, , , , , , , , , , , , , , , , , , , , , , , , , , , , , , , , , , , , , , ,#
#, , , , , , , , , , , , , , , , , , , , , , , , , , , , , , , , , , , , , , ,#
#, , , , , , , , , , , , , , , , , , , , , , , , , , , , , , , , , , , , , , ,#
#, , , , , , , , , , , , , , , , , , , , , , , , , , , , , , , , , , , , , , ,#
#, , , , , , , , , , , , , , , , , , , , , , , , , , , , , , , , , , , , , , ,#
#, , , , , , , , , , , , , , , , , , , , , , , , , , , , , , , , , , , , , , ,#
#, , , , , , , , , , , , , , , , , , , , , , , , , , , , , , , , , , , , , , ,#
#, , , , , , , , , , , , , , , , , , , , , , , , , , , , , , , , , , , , , , ,#
#, , , , , , , , , , , , , , , , , , , , , , , , , , , , , , , , , , , , , , ,#
#, , , , , , , , , , , , , , , , , , , , , , , , , , , , , , , , , , , , , , ,#
#, , , , , , , , , , , , , , , , , , , , , , , , , , , , , , , , , , , , , , ,#
#,#,#,#,#,#,#,#,#,#,#,#,#,#,#,#,#,#,#,#,#,#,#,#,#,#,#,#,#,#,#,#,#,#,#,#,#,#,#,#